9 9
5 1
7
1 5
4 4
4 6
5 9
6 4
6 6
9 5
0 0 0 0 2 0 0 0 0
0 0 0 0 1 0 0 0 0
0 0 0 0 1 0 0 0 0
0 0 0 1 1 1 0 0 0
1 1 1 1 0 1 1 1 1
0 0 0 1 1 1 0 0 0
0 0 0 0 1 0 0 0 0
0 0 0 0 1 0 0 0 0
0 0 0 0 1 0 0 0 0
