7 5
1 3
4
2 1
2 5
6 1
6 5
0 1 1 1 1 1 0
0 1 0 0 0 1 0
1 1 0 0 0 1 2
0 1 0 0 0 1 0
0 1 1 1 1 1 0
