7 13
4 13
6
3 11
5 9
1 2
7 2
4 5
4 1
0 0 0 1 0 0 0
0 0 0 1 0 0 0
0 0 1 1 0 0 0
0 0 0 1 0 0 0
0 0 0 1 1 0 0
0 0 0 1 0 0 0
0 0 1 1 1 0 0 
0 1 1 0 1 1 0
1 1 0 2 0 1 1
1 0 0 1 0 0 1
1 0 0 1 0 0 1
1 1 0 1 0 1 1
0 1 1 1 1 1 0
