10 10
3 10
7
4 8
8 7
10 8
1 3
3 4
8 1
7 3
1 1 1 0 0 1 1 1 1 1
1 0 0 0 0 1 0 0 0 1
1 0 1 1 0 1 1 1 0 1
1 0 1 0 0 1 0 1 0 0
1 1 1 1 1 1 0 0 0 0
0 0 0 0 1 1 1 1 1 1
0 0 1 0 1 0 0 1 0 1
1 0 1 1 1 0 1 1 0 1
1 0 0 0 1 0 0 0 0 1
1 1 1 1 1 0 0 2 1 1
