11 11
6 6
12
1 6
6 1
6 11
11 6
3 5
3 7
5 3
5 9
7 3
7 9
9 5
9 7
0 0 0 0 0 2 0 0 0 0 0
0 0 0 0 1 1 1 0 0 0 0
0 0 0 1 1 1 1 1 0 0 0
0 0 1 1 1 1 1 1 1 0 0
0 1 1 1 1 1 1 1 1 1 0
2 1 1 1 1 1 1 1 1 1 2
0 1 1 1 1 1 1 1 1 1 0
0 0 1 1 1 1 1 1 1 0 0
0 0 0 1 1 1 1 1 0 0 0
0 0 0 0 1 1 1 0 0 0 0
0 0 0 0 0 2 0 0 0 0 0
