13 11
7 6
16
1 1
1 5
5 1
5 5
1 7
5 7
1 11
5 11
9 1
9 5
13 1
13 5
9 7
9 11
13 7
13 11
1 1 1 1 1 0 0 0 1 1 1 1 1
1 1 1 1 1 0 0 0 1 1 1 1 1
1 1 2 1 1 0 0 0 1 1 2 1 1
1 1 1 1 1 0 0 0 1 1 1 1 1
1 1 1 1 1 1 1 1 1 1 1 1 1
0 0 0 0 0 1 1 1 0 0 0 0 0
1 1 1 1 1 1 1 1 1 1 1 1 1
1 1 1 1 1 0 0 0 1 1 1 1 1
1 1 2 1 1 0 0 0 1 1 2 1 1
1 1 1 1 1 0 0 0 1 1 1 1 1
1 1 1 1 1 0 0 0 1 1 1 1 1
