11 11
2 2
36
1 5
1 7
1 9
1 11
3 5
3 7
3 9
3 11
4 4
4 8
5 1
5 3
5 5
5 7
5 9
5 11
7 1
7 3
7 5
7 7
7 9
7 11
8 4
8 8
9 1
9 3
9 5
9 7
9 9
9 11
11 1
11 3
11 5
11 7
11 9
11 11
1 1 1 0 1 1 1 0 1 1 1
1 2 1 0 1 1 1 0 1 2 1
1 1 1 1 1 1 1 1 1 1 1
0 0 1 1 1 0 1 1 1 0 0
1 1 1 1 1 1 1 1 1 1 1
1 1 1 0 1 1 1 0 1 1 1
1 1 1 1 1 1 1 1 1 1 1
0 0 1 1 1 0 1 1 1 0 0
1 1 1 1 1 1 1 1 1 1 1
1 1 1 0 1 1 1 0 1 2 1
1 1 1 0 1 1 1 0 1 1 1
